12 15
.f.............
...f..f........
...............
..f.........s..
...............
.......f.......
...............
........h......
....f..........
.........f.....
...............
....f..........
